W: 23
H: 22
# # # # # # # # # # # # # # # # # # # # # # #
# _ S _ _ _ _ _ _ _ _ # _ _ _ _ S _ _ _ _ _ #
# _ # # # _ # # # # _ # _ # # # # _ # # # _ #
# _ # # # _ # # # # S # _ # # # # _ # # # _ #
# _ _ _ _ _ _ _ _ _ _ _ _ _ _ _ _ _ _ _ _ _ #
# _ # # # _ # _ # # # # # # # _ # _ # # # _ #
# _ S _ _ _ # _ _ _ _ # _ _ _ _ # _ S _ _ _ #
# # # # # _ # # # # - # - # # # # _ # # # # #
# # # # # _ # - - - - - G - - - # _ # # # # #
# # # # # _ # - # # # + # # # - # _ # # # # #
1 _ _ _ _ _ - - # G - G - G # - - _ _ _ _ _ 1
# # # # # _ # - # # # # # # # - # _ # # # # #
# # # # # _ # - - - p - P - - - # _ # # # # #
# # # # # _ # - # # # # # # # - # _ # # # # #
# _ _ _ S _ _ _ _ _ _ # _ _ _ _ _ _ S _ _ _ #
# _ # # # _ # # # # _ # _ # # # # _ # # # _ #
# _ S _ # _ _ _ _ _ _ S _ _ _ _ _ _ # _ _ _ #
# # # _ # _ # S # # # # # # # _ # _ # _ # # #
# _ _ _ _ _ # _ _ _ _ # _ _ S _ # _ _ _ _ _ #
# _ # # # # # # # # _ # _ # # # # # # # # _ #
# _ _ _ _ _ _ _ _ _ _ _ _ _ _ _ _ _ _ S _ _ #
# # # # # # # # # # # # # # # # # # # # # # #
